11 12 1 1
++++++++++++
+          +
+++  ++ ++ +
+ ++ ++ ++ +
+  + +  ++++
++   + +++?+
+++ ++   + +
++     +   +
+  +++++++++
+         ?+
++++++++++++
