7 50 5 1
++++++++++++++++++++++++++++++++++++++++++++++++++
+ +++ +++   ++++        ++         ++ +++++ ++++++
+ +++ +++ + +++  ++++++ +  +++ ++++++ +++++ ++++++
+     ++     ++      ++   ++++   ++++ +++++ ++++++
+ +++ ++ +++ ++++++  ++ +  +++ ++++++ +++++ ++++++
+ +++    +++        +++ ++  ++                  ?+
++++++++++++++++++++++++++++++++++++++++++++++++++
